 



ESTADO DE SANTA CATARINA

MUNICÍPIO DE CHAPECÓ


REPUBLICAÇÃO POR INCORREÇÃO

DECRETO Nº. 39.328, DE 24 DE AGOSTO DE 2020.
Dispõe sobre criação e nomeação dos membros da Comissão Intersetorial do Transporte Coletivo Urbano de Passageiros de Chapecó e dá outras providências



O Prefeito Municipal de Chapecó, Estado de Santa Catarina, no uso de suas atribuições legais e de acordo com o inciso IV do artigo 77 da Lei Orgânica do Município de Chapecó e,

CONSIDERANDO que o Município de Chapecó, conforme preceitua a Constituição da República Federativa do Brasil em seu artigo 30, inciso V tem a competência para organizar e prestar, diretamente ou sob regime de concessão ou permissão, os serviços públicos de interesse local, incluído o de transporte coletivo, que tem caráter essencial.

CONSIDERANDO que o Sistema de Transporte Coletivo Urbano de Passageiros no Município de Chapecó é regulado pela Lei Complementar municipal nº. 467, de 20 de outubro de 2011 e pelo Decreto nº. 25.029, de 22 de dezembro de 2011 e demais legislação vigente que trata da referida matéria.

CONISDERANDO que a criação da Comissão Intersetorial do Transporte Coletivo Urbano de Passageiros de Chapecó composta por órgãos e entidades governamentais e não governamentais, com objetivo de discutir e assessorar o Poder Executivo Municipal nas ações desta política é forma de tornar ainda mais democrática as decisões das ações governamentais alusivas ao transporte coletivo urbano de passageiros,


D E C R E T A :

Art. 1º. Fica criada a Comissão Intersetorial do Transporte Coletivo Urbano de Passageiros de Chapecó com objetivo de discutir e assessorar o Poder Executivo Municipal nas ações da política municipal de transporte coletivo urbano de passageiros de Chapecó.


Art. 2º. Ficam nomeados para compor a Comissão Intersetorial do Transporte Coletivo Urbano de Passageiros de Chapecó:


I - Representantes do Poder Executivo Municipal:
a) INAJARA APARECIDA ANTONINI - Secretária de Defesa do Cidadão e Mobilidade - Presidente;

b) JOÃO CARLOS VALENTIM VEIGA JUNIOR - Técnico em Administração - Secretário;



c) LEILA JANINE ANTONINI DE SOUZA - Diretora de Mobilidade Urbana;



d) REBECA MACIEL CAMARGO - Gerente de Mobilidade Urbana;



e) JUNIOR ASSIS STRELLO - Comandante da Guarda Municipal;

f) ELTON PEREIRA LANZARIN - Gerente de Fiscalização de Transportes Públicos;



g) PEDRO LUIZ VOLKWEIS FILHO - Procurador Geral do Município;


h) GUILHERME REGINATO TILMANN - Consultor Jurídico;



i) GERALCI JOAO AMPOLINI - Secretário de Fazenda;


j) ROBERTO ZOLET - Contador Geral do Município;


k) GILVANE SCHEREN - Contador;


l) RIQUELMO BEDIN FILHO - Diretor de Gestão de Compras;


m) ALEXEI ANHALT - Controlador Geral do Município;


n) MELIZE VASSOLER PORTELA - Gerente de Normatização de Procedimentos;


o) ANDRESSA POMPEU DA SILVA - Auditora de Controle Interno; 



p) LAILA ASIRIA SCHENKEL - Auditora de Controle Interno;


q) JACSON EDU MENEGHETTI - Auditor de Controle Interno.


II - Representantes da sociedade civil organizada:



a) CARLOS MARTINELLI - representa da Associação Comercial e Industrial de Chapecó - ACIC;



b) ANDRÉ TOZZO - representante do Sindicato do Comércio da Região de Chapecó - SICOM;



c) JOÃO CARLOS SCOPEL - representante do Centro Empresarial Chapecó - CEC;



d) MARCELO BATTIROLA - representante da Ordem dos Advogados do Brasil - Subseção Chapecó;



e) RENAN SOARES DE SOUZA - representante da Defensoria Pública de Santa Catarina;



f) PAULO CESAR MARTINS - representante do Conselho Municipal da Pessoa com Deficiência - COMDE;



g) ANA PAULA FACHINETTO - representante da Universidade do Oeste de Santa Catarina - UDESC OESTE - Centro de Educação Superior do Oeste;



h) MÁRCIA REGINA SARTORI DAMO - representante da Universidade do Oeste de Santa Catarina - UNOESC - Campus Chapecó;



i) REGINA BALARDIN ANTONINI - representante da Universidade Comunitária da Região de Chapecó - UNOCHAPECÓ;



j) RAFAEL SANTIN SCHEFFER - representante da Universidade Federal da Fronteira Sul - UFFS;



k) MARCELINO CLAIR DE LIMA - representante do Sindicato dos Condutores de Veículos e Trabalhadores nas Empresas de Transporte Coletivo de Chapecó e Região - SITTRACOL;



l) CELSO CAPELLARO - representante do Sindicato das Indústrias de Carnes e Derivados - SINDICARNE - Autora Alimentos;



m) RUTI CRISTIANE PEREIRA DOS SANTOS - representante do Sindicato das Indústrias de Carnes e Derivados - SINDICARNE - BRF;



n) DILMAR ZITO ZONTA - representante do Sindicato de Transporte de Passageiros do Oeste Catarinense - SINTROESTE;



o) JENIR PONCIANO DE PAULA - representante do Sindicato dos Trabalhadores nas Indústrias das Carnes e Derivados de Chapecó - SITRACARNES;



p) CLÓVIS AFONSO SPOHR - representante da Câmara de Dirigentes Lojistas - CDL;



q) ANILTON ANTONIO RIBEIRO - representante da Associação dos Aposentados e Pensionistas de Chapecó - ASAPREV.


Art. 3º. Os membros, ora nomeados, não serão remunerados pelo exercício de suas funções na Comissão e prestarão serviços considerados relevantes ao município.


Art. 4º. Este Decreto entra em vigor na data de sua publicação.

                                                             Gabinete do Prefeito Municipal de Chapecó, Estado de Santa Catarina, em 24 de agosto de 2020.

LUCIANO JOSÉ BULIGON

Prefeito Municipal

PAGE  

