 



ESTADO DE SANTA CATARINA

MUNICÍPIO DE CHAPECÓ


DECRETO Nº. 39.485, DE 23 DE OUTUBRO DE 2020.

Dispõe sobre a criação da Comissão de Organização da Conferência Municipal de Cultura e dá outras providências.



O Prefeito Municipal de Chapecó, Estado de Santa Catarina, no uso de suas atribuições legais que lhe confere o inciso IV, do artigo 77 da Lei Orgânica do Município de Chapecó, e;



CONSIDERANDO o disposto na Resolução nº 008, de 20 de outubro de 2020 do Conselho Municipal de Políticas Culturais - CMPC, 


D E C R E T A :



Art. 1º. Fica criada a Comissão Organizadora da Conferência Municipal de Cultura.



Art. 2°. A Comissão será composta pelos seguintes membros:

I -  Conselheiros e representantes da Sociedade Civil: 

a) CLODOALDO CALAI - Artes Cênicas;

b) DANIEL DALLA ZEN - Patrimônio Cultural;

c) DEISE CRISTIANE DE LUCA - Sistema S – SESC;

d) DJONATAN VICTOR FRONZA - Segmento Cultural – Música;

e) JAKSON RONALDO KREUZ - Secretaria de Cultura – Arte Cidadã / CEC;

f) LOUIS AUGUSTO RADAVELLI– Sociedade Civil;

g) MARI ÂNGELA GIORDANI BALDISSERA - Artes Visuais;

h) NEMÉSIO CARLOS DA SILVA – Sociedade Civil.

II -  servidores da Secretaria de Cultura: 

a) ALANA CARLA MIOR – Auxiliar de Administração;

b) AUGUSTO ZEISER – Técnico em Cinema (Audiovisual);

c) FERNANDA SALVI – Produtor/Programador;

d) IGOR ANTONIO GIROTTO – Secretário de Cultura Interino

e) IZABEL CRISTINA DE QUADROS – Monitor Social;

f) JULIANA ROBERTA HOEHN – Técnica em Admnistração;

g) LUCIÉLE POMPEO – Gerente de Cultura;

h) THAYS FORTES BORGES FERRARACCIO – Auxiliar de Administração.

Art. 3º. São atribuições da comissão organizadora:

I - definir plano de ação e metodologia de trabalho;

II - elaborar regimento interno;

III - elaborar a proposta metodológica e a programação da Conferência Municipal de Cultura;

IV - divulgar o evento;

V - elaborar documento com as diretrizes para a realização das pré-conferências;

VI - organizar material necessário à realização da conferência;

VII - realizar o credenciamento dos participantes;

VIII - organizar todos os procedimentos necessários à realização da conferência.

Art. 4º. Este Decreto entra em vigor na data de sua publicação.

Gabinete do Prefeito Municipal de Chapecó, Estado de Santa Catarina, em 23 de outubro de 2020.

LUCIANO JOSÉ BULIGON

Prefeito Municipal
PAGE  

