



ESTADO DE SANTA CATARINA
MUNICÍPIO DE CHAPECÓ 
SECRETARIA DE JUVENTUDE, ESPORTE E LAZER



TERMO DE HOMOLOGAÇÃO DO EDITAL nº 003/2019



                 O Município de Chapecó, Santa Catarina, pessoa jurídica de direito público interno, inscrito no CNPJ 83.021.808/0001-82, representado neste ato pelo Sr, Rafael Foppa, Secretário de Juventude, Esporte e Lazer, torna público para conhecimento dos interessados, que HOMOLOGA os projetos abaixo do chamamento público nº 003/2019, conforme segue.
	- Clube de Atletismo Chapecó – Atletismo Masculino e Feminino
	- Clube de Basquete de Chapecó - Basquete Masculino e Feminino
- Associação Chapecoense de Bocha e Bolão - Bocha Masculino e Feminino
- Associação Chapecoense do Bocha e Bolão - Bolão 23 Masculino e Feminino
- Associação Pró-Ciclismo Chapecó - Ciclismo Masculino e Feminino
- Associação Chapecoense de Futsal - Futsal Masculino
- Associação Female Futsal - Futsal Feminino
- Associação Desportiva Lourdes Lago - Futebol Masculino e Feminino
- Associação de Ginástica Rítmica de Chapecó - Ginástica Rítmica
- Associação Amigos do Handebol - Handebol Masculino
- Associação de Handebol Feminino - Handebol Feminino
- Associação Desportiva Chapecó de Judô - Judô Masculino
- Associação de Pais e Amigos do Judô - Judô Feminino
- Associação Brasileira de Karatê - Karatê Masculino e Feminino
- Associação Chapecoense de Natação - Natação Masculino e Feminino
- Associação Chapecoense de Taekwondo - Taekwondo Masculino e Feminino
- Associação Chapecoense de Tênis de Mesa - Tênis de Mesa Masculino e Feminino
- Clube de Tiro Caça e Pesca Caramuru - Tiro Armas Curtas
- Associação Chapecoense de Caça e Tiro - Tiro ao Prato - 
- Associação Pró-Vôlei de Chapecó - Vôlei Masculino
- Associação Chapecoense de Voleibol - Vôlei Feminino
- Clube Paradesportivo Falcões do Oeste - Deficientes Físicos
- Associação de Surdos de Chapecó - Deficientes Auditivos
- Associação de Deficientes Visuais do Oeste de Santa Catarina - Deficientes Visuais
- Clube de Xadrez de Chapecó - Xadrez Masculino e Feminino


Chapecó, 27 de janeiro de 2020.


Rafael Foppa

Registre-se
Publica-se
SECRETARIA  DE JUVENTUDE, ESPORTE E LAZER- FONE /FAX – 33 19 10 50- esporte@chapeco.sc.gov.br
Rua Clevelândia, N° 807 – E  - CEP 89801 – 561   CHAPECÓ/SC
 

